Zarasa
An Interactive Fiction by Ignacio Mollo
Release 1 / Serial number 171024 / Inform 7 build 6M62 (I6/v6.33 lib 6/12N) SD

Abstract Mathematical Setting
You feel like you could move in infinitely many independent directions if you tried.

Lying in the floor and unable to move by itself, there is a constant function.

You can also see a sign function, a differential operator, a solid number and a linear function here.

>differentiate constant function
I wouldn't know where to start!

>take the differential operator
Taken.

>derive the constant function
(taking the constant function first)It was his own fault, really.

>x constant function
 It has a label on it, which reads "0".

* * *

Zarasa
An Interactive Fiction by Ignacio Mollo
Release 1 / Serial number 171024 / Inform 7 build 6M62 (I6/v6.33 lib 6/12N) SD

Abstract Mathematical Setting
You feel like you could move in infinitely many independent directions if you tried.

Lying in the floor and unable to move by itself, there is a constant function.

You can also see a sign function, a differential operator, a solid number and a linear function here.

>test me
(Testing.)

>[1] derive constant function
I wouldn't know where to start!

>[2] take differential operator
Taken.

>[3] derive constant function
(taking the constant function first)

It was his own fault, really.

>[4] x constant function
 It has a label on it, which reads "0".

* * *

Zarasa
An Interactive Fiction by Ignacio Mollo
Release 1 / Serial number 171024 / Inform 7 build 6M62 (I6/v6.33 lib 6/12N) SD

Abstract Mathematical Setting
You feel like you could move in infinitely many independent directions if you tried.

Lying in the floor and unable to move by itself, there is a constant function.

You can also see a sign function, a differential operator, a solid number and a linear function here.

>test crap
(Testing.)

>[1] derive constant function
I wouldn't know where to start!

>[2] take differential operator
Taken.

>[3] derive constant function
(taking the constant function first)

It was his own fault, really.

>[4] x constant function
 It has a label on it, which reads "0".

>ask constant function about weather
You can't use multiple objects with that verb.

>ask constant function about the weather
You can't use multiple objects with that verb.

>ask the constant function about the weather
You can't use multiple objects with that verb.

>ask the constant function about weather
You can't use multiple objects with that verb.

>ask constant function about weather
You can't use multiple objects with that verb.

>ask constant function about asdqw
You can't use multiple objects with that verb.

>consult constant function about adnqw
0

>ask constant function about adnqw
You can't use multiple objects with that verb.

>ask constant function
You can't use multiple objects with that verb.

>ask myself
What do you want to ask yourself for?

>weather
You can't see any such thing.

>ask myself about constant function
There is no reply.

>ask constant function about constant function
You can't use multiple objects with that verb.

>ask "constant function" about constant function
You can't see any such thing.

>ask "constant function" about "constant function"
You can't see any such thing.

>ask constant function about "constant function"
You can't use multiple objects with that verb.

* * *

Zarasa
An Interactive Fiction by Ignacio Mollo
Release 1 / Serial number 171024 / Inform 7 build 6M62 (I6/v6.33 lib 6/12N) SD

Abstract Mathematical Setting
You feel like you could move in infinitely many independent directions if you tried.

Lying in the floor and unable to move by itself, there is a constant function.

You can also see a sign function, a differential operator, a solid number and a linear function here.

>test derive
(Testing.)

>[1] derive myself
That noun did not make sense in this context.

>[2] differentiate myself
That noun did not make sense in this context.

>[3] derive constant function
I wouldn't know where to start!

>[4] take differential operator
Taken.

>[5] derive constant function
It was his own fault, really.

(taking the constant function first)

>[6] x constant function
 It has a label on it, which reads 0 .

>derive myself
That noun did not make sense in this context.

>differentiate myself
That noun did not make sense in this context.

* * *

>test derive
(Testing.)

>[1] derive myself
That noun did not make sense in this context.

>[2] differentiate myself
That noun did not make sense in this context.

>[3] derive constant function
I wouldn't know where to start!

>[4] take differential operator
Taken.

>[5] derive constant function
It was his own fault, really.

(taking the constant function first)

>[6] x constant function
 It has a label on it, which reads 0 .

>test evaluate
(Testing.)

>[1] evaluate sign function on number
(first taking the sign function)

It evaluates to -1.

>[2] evaluate sign function on constant function
It evaluates to 1.

>[3] evaluate linear function on number
(first taking the linear function)

It evaluates to -13.0.

>[4] evaluate linear function on constant function
It evaluates to 1.0.

* * *

Zarasa
An Interactive Fiction by Ignacio Mollo
Release 1 / Serial number 171024 / Inform 7 build 6M62 (I6/v6.33 lib 6/12N) SD

Abstract Mathematical Setting
You feel like you could move in infinitely many independent directions if you tried.

Lying in the floor and unable to move by itself, there is a constant function.

You can also see a sign function, a differential operator, a solid number and a linear function here.

>evaluate myself
That noun did not make sense in this context.

* * *

Zarasa
An Interactive Fiction by Ignacio Mollo
Release 1 / Serial number 171024 / Inform 7 build 6M62 (I6/v6.33 lib 6/12N) SD

Abstract Mathematical Setting
You feel like you could move in infinitely many independent directions if you tried.

Lying in the floor and unable to move by itself, there is a constant function.

You can also see a sign function, a differential operator, a solid number and a linear function here.

>take function
Taken.

>x funtion
You can't see any such thing.

>x function
 It has a label on it, which reads "5.0".

>consult function about weather
5.0

>tell function laksd
You can only do that to something animate.

* * *

>take function
Taken.

>x function
 It has a label on it, which reads  5.7.

>consult constant function about weather
5

* * *

>x function
 It has a label on it, which reads  5.7.

>x number
It has the form of a 7 . It looks sturdy.

* * *

Zarasa
An Interactive Fiction by Ignacio Mollo
Release 1 / Serial number 171024 / Inform 7 build 6M62 (I6/v6.33 lib 6/12N) SD

Abstract Mathematical Setting
You feel like you could move in infinitely many independent directions if you tried.

Lying in the floor and unable to move by itself, there is a constant function.

You can also see a sign function, a differential operator, a solid number and a linear function here.

>consult constant function about weather
5

* * *

Zarasa
An Interactive Fiction by Ignacio Mollo
Release 1 / Serial number 171024 / Inform 7 build 6M62 (I6/v6.33 lib 6/12N) SD

Abstract Mathematical Setting
You feel like you could move in infinitely many independent directions if you tried.

Lying in the floor and unable to move by itself, there is a constant function.

You can also see a sign function, a differential operator, a solid number and a linear function here.

>x function
 It looks boring.

>take function
Taken.

>x function
 It has a label on it, which reads 5 .

* * *

Zarasa
An Interactive Fiction by Ignacio Mollo
Release 1 / Serial number 171024 / Inform 7 build 6M62 (I6/v6.33 lib 6/12N) SD

Abstract Mathematical Setting
You feel like you could move in infinitely many independent directions if you tried.

Lying in the floor and unable to move by itself, there is a constant function.

You can also see a sign function, a differential operator, a solid number and a linear function here.

>take solid number
Taken.

>x solid number
You see nothing special about the solid number.

* * *

Zarasa
An Interactive Fiction by Ignacio Mollo
Release 1 / Serial number 171024 / Inform 7 build 6M62 (I6/v6.33 lib 6/12N) SD

Abstract Mathematical Setting
You feel like you could move in infinitely many independent directions if you tried.

Lying in the floor and unable to move by itself, there is a constant function.

You can also see a sign function, a differential operator, a solid number and a linear function here.

>x solid number
It has the form of a 8 . It looks sturdy.

* * *

Zarasa
An Interactive Fiction by Ignacio Mollo
Release 1 / Serial number 171024 / Inform 7 build 6M62 (I6/v6.33 lib 6/12N) SD

Abstract Mathematical Setting
You feel like you could move in infinitely many independent directions if you tried.

Lying in the floor and unable to move by itself, there is a constant function.

You can also see a sign function, a differential operator, a solid number and a linear function here.

>x number
It has the form of a  7.5. It looks sturdy.

>take function
Taken.

>x function
 It has a label on it, which reads 6 .

* * *

Zarasa
An Interactive Fiction by Ignacio Mollo
Release 1 / Serial number 171024 / Inform 7 build 6M62 (I6/v6.33 lib 6/12N) SD

Abstract Mathematical Setting
You feel like you could move in infinitely many independent directions if you tried.

Lying in the floor and unable to move by itself, there is a constant function.

You can also see a sign function, a differential operator, a solid number and a linear function here.

>x constant function
 It looks boring.

>take constant function
Taken.

>x constant function
 It has a label on it, which reads 6 .

* * *

Zarasa
An Interactive Fiction by Ignacio Mollo
Release 1 / Serial number 171024 / Inform 7 build 6M62 (I6/v6.33 lib 6/12N) SD

Abstract Mathematical Setting
You feel like you could move in infinitely many independent directions if you tried.

Lying in the floor and unable to move by itself, there is a constant function.

You can also see a sign function, a differential operator, a solid number and a linear function here.

>x number seven
It has the form of a 7 . It looks sturdy.

>grab number
That's not a verb I recognise.

>take number
Taken.

>evaluate constant function on number seven
(first taking the constant function)

It evaluates to  5.7

* * *

Zarasa
An Interactive Fiction by Ignacio Mollo
Release 1 / Serial number 171024 / Inform 7 build 6M62 (I6/v6.33 lib 6/12N) SD

Abstract Mathematical Setting
You feel like you could move in infinitely many independent directions if you tried.

Lying in the floor and unable to move by itself, there is a constant function.

You can also see a sign function, a differential operator, a solid number and a linear function here.

>evaluate sign function on number seven
(first taking the sign function)

It evaluates to 1.

* * *

Zarasa
An Interactive Fiction by Ignacio Mollo
Release 1 / Serial number 171024 / Inform 7 build 6M62 (I6/v6.33 lib 6/12N) SD

Abstract Mathematical Setting
You feel like you could move in infinitely many independent directions if you tried.

Lying in the floor and unable to move by itself, there is a constant function.

You can also see a sign function, a differential operator, a solid number and a linear function here.

>test evaluate
(Testing.)

>[1] evaluate sign function on number
(first taking the sign function)

It evaluates to -1.

>[2] evaluate sign function on constant function
(first taking the constant function)

It evaluates to 1.

>[3] evaluate linear function on number
(first taking the linear function)

It evaluates to -13.0.

>[4] evaluate linear function on constant function
It evaluates to 12.4.

>test derive
(Testing.)

>[1] derive myself
That noun did not make sense in this context.

>[2] differentiate myself
That noun did not make sense in this context.

>[3] derive constant function
I wouldn't know where to start!

>[4] take differential operator
Taken.

>[5] derive constant function
It was his own fault, really.

>[6] x constant function
 It has a label on it, which reads 0 .

* * *

Zarasa
An Interactive Fiction by Ignacio Mollo
Release 1 / Serial number 171024 / Inform 7 build 6M62 (I6/v6.33 lib 6/12N) SD

Abstract Mathematical Setting
You feel like you could move in infinitely many independent directions if you tried.

Lying in the floor and unable to move by itself, there is a constant function.

You can also see a sign function, a differential operator, a solid number and a linear function here.

>Test evaluate
(Testing.)

>[1] evaluate sign function on number
(first taking the sign function)

It evaluates to -1.

>[2] evaluate sign function on constant function
(first taking the constant function)

It evaluates to 1.

>[3] evaluate linear function on number
(first taking the linear function)

It evaluates to 
*** Run-time problem P10: Since the linear function is not allowed the property "stubbornness", it is against the rules to try to use it.

1.0.

>[4] evaluate linear function on constant function
It evaluates to 
*** Run-time problem P10: Since the linear function is not allowed the property "stubbornness", it is against the rules to try to use it.

1.0.